########################################
#......................................#
#x.....................................#
#......................................#
###############################........#
#......................................#
#......................................#
#......................................#
#........#.............................#
#........#.............................#
#........#.............................#
#........###############################
#......................................#
#......................................#
#......................................#
#.............................#........#
#.............................#........#
#.............................#........#
###############################........#
#......................................#
#......................................#
#......................................#
#........#.............................#
#........#.............................#
#........#.............................#
#........###############################
#......................................#
#......................................#
#......................................#
#.............................#........#
#.............................#........#
#.............................#........#
###############################........#
#......................................#
#......................................#
#......................................#
#......................................#
#......................................#
#@.....................................#
########################################
