########################################
#......................................#
#......................................#
#......................................#
###%%##################................#
#..................... ................#
#..................... ................#
#..................... ................#
#............      ####................#
#............ .........................#
#.....%...... .........................#
#....#x#..... .........................#
#.....#...... .........................#
#............ .........................#
#............ ......###########........#
#............ ......#.........#........#
#............ ......#.........#........#
#............ ......#......  ..........#
#............ ......#..................#
##############################%%########
#......................................#
#......###########################     #
#................................#     #
################.................#     #
#..............###############.........#
#.........#..................#.........#
#.........#..................#.........#
#.........################...#####.....#
#........................#.............#
#........................#.............#
#################.....##################
#.............#...  ...................#
#.............#........................#
#.............#........................#
#.............############.............#
#........................#.............#
#....  ..................#.............#
#......................................#
#@......  .............................#
########################################
